1ZDZ1Z1DDDDD1ZDD1DDZD11433C00+;+;244ZDDD1ZDD
1ZD1ZZZ11D11DD111Z11ZZ202300;+BB4004111DZZD1
DZZDDDDDDDDDZ1DDZZZD1Z024040;BB440204ZD1ZDZZ
ZD1DZZDZ1ZD1DD11Z1DZD24C42224++B;42C0D1ZDZZ1
Z11DZ11DZ1ZZZZ11DZZDZ40040404;;+;40F41D1DDZZ
D1DZ11D11D1DZDDZ1Z1100202004+BB0404C0D1DZZDD
ZZZZZD11ZDZ1111DZDZD24040042BB;2204021DDZDZD
1DD11DZ1DDDD1D11111Z1124244;B+;20002D111ZDD1
DDZ1ZZZ1DZDZ1DDDZ1D1DZ24042+;+2200241Z1ZDDD1
ZZD1DDD11ZD11D1ZZ1Z1ZZZ0202;;0204421D11ZD1DD
ZZ1D11D11D1DZDDDD1DZD1442420B02442ZDZ1111111
DDD1D1ZD1ZDZ11ZDZDZ1D024402224200ZZ1D1ZD1DDZ
ZZZD1D1DD1ZZZZZ1ZDD12220F2422201D11ZDD11Z1ZD
11Z11022Z1ZDZ1DDZZ1Z120C0F420241DDZ1D11ZD1ZD
1ZZZ02FF301DZD1Z11Z11220C00004DD111Z1ZD1DZ11
ZZD1Z42202001D11Z1ZZDDZ4044441Z1DZDZ1DZD1ZDZ
DDZD1ZZ1040F4ZDZZD1Z1Z1ZD1Z1ZZZDDZDZ111ZZZD1
ZZZ1DZZD10022DZ111DZ11DD1ZZ1Z11ZDZDDD1ZD1DZD
Z11D1ZD1D12301ZZ1DDDZZDD1DD11Z1DZZZZDZZZZDZ1
D1ZDDD1Z11Z2DDZDD1DZZ100040Z1ZZDZZDZDZDD11Z1
DZDDZZ11DZ111D11Z1Z1Z4402F221Z111ZZ11Z1DZ1Z1
1D1Z11ZDZ1DDZZZ1D1Z11ZD0FCF001Z1Z1DDDZD111Z1
DD1DDDZDDZZ1ZZZZ1DZ1D1D42C42ZDZZDDZ1ZDD1ZZZD
Z1DDZDZZD1DZDZ1ZD1ZDDD4401D11ZD1Z1Z111DDD1ZZ
Z1DZD1Z1D11Z1111DZ1DD11DZDZ11DDDDD11ZZZ1Z11Z
D1ZD11DZDDZ11D1D1D1ZZZ11DZDZDZZD11ZD1DDZZZDD
DZZDZ1ZDZDZ1Z1DZDDZ11ZDZ1D1DDD1DD1D1DZDDZ11D
1(|1ACQR|##|#*#####*|#*#*|*#*|**|||*###|**||
C9|CR77#*#||||##||||*#|**#|####|||*|#|#*|||#
09*GRASS||*#|###|#*#*|##**##|###*||***|#*##*
;(*XOUNFAIN|*|##*###*##||###*##***||*#*#|###
